S,S,S,M,M,M,M,M,N,N,N,N,N,N,E
M,M,M,M,M,M,M,M,N,T,N,T,N,N,R
M,M,M,M,M,M,M,M,N,R,R,R,R,R,R
M,M,M,M,M,M,N,N,T,R,N,T,N,N,N
M,M,M,M,S,S,S,N,N,R,R,R,R,R,N
M,M,N,S,S,S,S,S,T,N,N,T,N,R,T
N,N,N,T,S,S,S,S,S,N,R,R,R,R,N
N,R,R,R,R,R,R,R,R,R,R,T,N,N,N
T,R,N,T,N,N,S,S,S,S,S,N,N,M,M
N,R,R,R,R,R,N,S,S,S,S,S,M,M,M
N,N,N,T,N,R,R,N,S,S,M,M,M,M,M
N,N,R,R,R,N,R,N,M,M,M,M,M,M,M
N,T,R,T,R,T,R,T,M,M,M,M,M,M,M
N,T,R,N,R,N,R,M,M,M,M,M,M,S,S
P,R,R,T,R,R,R,M,M,M,M,M,S,S,S